


SO   ./textures/xpm/wall.xpm

   NO   ./textures/xpm/wall.xpm
           
           WE   ./textures/xpm/wall.xpm
           EA    ./textures/xpm/wall.xpm

             F  ./textures/xpm/wall.xpm

    C 89,30,222









111111111111111111111111111
100000000000000000000000001
100000000000000000000000001
100000000000000000000000001
100000000000000000000000001
100000000000000000000000001
100000000000000000000000001
100000000000000000000000001
100000000000000000000000001
100000000000000000000000001
1000000000000N0000000000001
111111111111111111111111111