


SO   ./textures/xpm/wall.xpm

   NO   ./textures/xpm/wall.xpm
           
           WE   ./textures/xpm/wall.xpm
           EA    ./textures/xpm/wall.xpm

             F  133, 124, 65

    C 0,0,0












        1111111111111111111111111
        1000000000110000000000001
        1011000001110000000000001
        100100000000000000000011
1111111101100001110000000000001
100000000011000001110111111111111
1111011111  1100011100000010001
111101111111110001010100100011
  11000000110100011100000010001
  1000000100000001100000N10001
  1000000000000001101010010001
  1100000111010101111101111000111
  11110111 1110101 101111010001
  11111111 11111111111111111111